RRRRRRRRRRRORRORRORRRORRORRRRR
RRRRRRRRRRRRRRPOROOOORRRRRORRR
OOOOOOORRROOOORRRRPRRRRRRRROOO
OOOOORRRRRRRRRRROOORPRRRRGGGGG
GGRGRGRGRGRRGRGRGRGRGRGRGRGGGR
RGGGRRRRRGGGGGGGGGGGRRRGGGRRGG
PPPPOOOOOOGGGGPRROOOOOGGGGGGGG
GGGGOOOOOORRRRPRROOOOOGGGGGGGG
GGGGGGGGGRRRRPRRROOOOOGGGGGGGG
GGGGGGGGGRRRRRPRROOOOOGGGGGGGG
OOOOOOOOOOOOORRGGGGGGGGGGGGGGG
GGGGGGGGGGGGPRRRGRGRGRGRGRGRGR
GGGGGGGGGGGGPRRRGRGRGRGRGRGRGR
GGGGGGGGGGGGPRRGGRGGGRGRGRGRGR
OOOOOOOOOOOOPPPPPPPPPPPPPPPPPP
RRRRGGGGGRRORRRRRRRRRRRRRRRRRR
RRRRGGGGGRRORRORRORORORORORRRR
RRRRGGGGGRRORRRRORRORRRRRRRROO
RRRRRRRRRRRORRORRORRRORRORRRRR
RRRRRRRRRRRRRRPOROOOORRRRRORRR
OOOOOOORRROOOORRRRPRRRRRRRROOO
OOOOORRRRRRRRRRROOORPRRRRGGGGG
GGGGGGRRRRRRRRPRRRRGGGGGGRRRRR
GGGGGGRRRPOOOOPRRRRGGGGGGRRRRR
GGGGGGRRROGGGGPRRRRGGGGGGRRRRR
GGGGGGRRROGGGGPRRRRRROOPOOOOOO
PPPPOOOOOOGGGGPRROOOOOGGGGGGGG
GGGGOOOOOORRRRPRROOOOOGGGGGGGG
GGGGGGGGGRRRRPRRROOOOOGGGGGGGG
GGGGGGGGGRRRRRPRROOOOOGGGGGGGG